1,2,1,7
1,1,1,1,1,1,1,1,1
2,2,0,2,3,0,0,0,5
2,0,0,2,0,3,4,3,2
2,0,3,0,3,0,3,3,2
2,3,4,3,0,0,0,4,2
2,0,3,0,2,0,2,2,2
1,1,1,1,1,1,1,1,1