3,4,3,7
1,1,1,1,1,1,1,1,1
2,2,0,0,2,0,4,2,2
2,0,3,3,3,3,3,0,2
2,4,0,3,0,3,0,0,5
2,0,3,3,3,3,3,0,2
2,2,4,0,2,0,0,2,2
1,1,1,1,1,1,1,1,1