1111111111
1100000001
1111110101
1000000301
1011111111
1011111111